  1 --- [] (all around the world)
  2                                  Alaska (AK)	[United States]
  3                                 Arizona (AZ)	[United States]
  4                                Arkansas (AR)	[United States]
  5                              California (CA)	[United States]
  6                                Colorado (CO)	[United States]
  7                             Connecticut (CT)	[United States]
  8                    District of Columbia (DC)	[United States]
  9                                Delaware (DE)	[United States]
 10                                 Florida (FL)	[United States]
 11                                 Georgia (GA)	[United States]
 12                                  Hawaii (HI)	[United States]
 13                                   Idaho (ID)	[United States]
 14                                Illinois (IL)	[United States]
 15                                 Indiana (IN)	[United States]
 16                                    Iowa (IA)	[United States]
 17                                  Kansas (KS)	[United States]
 18                                Kentucky (KY)	[United States]
 19                               Louisiana (LA)	[United States]
 20                                   Maine (ME)	[United States]
 21                                Maryland (MD)	[United States]
 22                           Massachusetts (MA)	[United States]
 23                                Michigan (MI)	[United States]
 24                               Minnesota (MN)	[United States]
 25                             Mississippi (MS)	[United States]
 26                                Missouri (MO)	[United States]
 27                                 Montana (MT)	[United States]
 28                                Nebraska (NE)	[United States]
 29                                  Nevada (NV)	[United States]
 30                           New Hampshire (NH)	[United States]
 31                              New Jersey (NJ)	[United States]
 32                              New Mexico (NM)	[United States]
 33                                New York (NY)	[United States]
 34                          North Carolina (NC)	[United States]
 35                            North Dakota (ND)	[United States]
 36                                    Ohio (OH)	[United States]
 37                                Oklahoma (OK)	[United States]
 38                                  Oregon (OR)	[United States]
 39                            Pennsylvania (PA)	[United States]
 40                            Rhode Island (RI)	[United States]
 41                          South Carolina (SC)	[United States]
 42                            South Dakota (SD)	[United States]
 43                               Tennessee (TN)	[United States]
 44                                   Texas (TX)	[United States]
 45                                    Utah (UT)	[United States]
 46                                 Vermont (VT)	[United States]
 47                                Virginia (VA)	[United States]
 48                              Washington (WA)	[United States]
 49                           West Virginia (WV)	[United States]
 50                               Wisconsin (WI)	[United States]
 51                                 Wyoming (WY)	[United States]
 52                  New South Wales (australia)	[Australia]
 53                                     Victoria	[Australia]
 54                       Queensland (australia)	[Australia]
 55                  South Australia (australia)	[Australia]
 56                Western Australia (australia)	[Australia]
 57                         Tasmania (australia)	[Australia]
 58               Northern Territory (australia)	[Australia]
 59     Australian Capital Territory (australia)	[Australia]
 60                                 Alabama (AL)	[United States]
 61 --- []
 62                                  Québec (QC)	[Canada]
 63                                 Alberta (AB)	[Canada]
 64                        British Columbia (BC)	[Canada]
 65                                Manitoba (MB)	[Canada]
 66                           New Brunswick (NB)	[Canada]
 67               Newfoundland and Labrador (NL)	[Canada]
 68                             Nova Scotia (NS)	[Canada]
 69                                 Ontario (ON)	[Canada]
 70                    Prince Edward Island (PE)	[Canada]
 71                            Saskatchewan (SK)	[Canada]
 72                   Northwest Territories (NT)	[Canada]
 73                                 Nunavut (NU)	[Canada]
 74                         Yukon Territory (YT)	[Canada]
 75 --- []
 76                              Oost-Vlaanderen	[Belgium]
 77 --- []
 78                               Vlaams-Brabant	[Belgium]
 79 --- []
 80                                        Liège	[Belgium]
 81                                        Namur	[Belgium]
 82                                 North Island	[New Zealand]
 83 --- []
 84 --- []
 85 --- []
 86                                 South Island	[New Zealand]
 87                                    Antwerpen	[Belgium]
 88                                      Hainaut	[Belgium]
 89                                      Limburg	[Belgium]
 90                                   Luxembourg	[Belgium]
 91                               Brabant wallon	[Belgium]
 92                              West-Vlaanderen	[Belgium]
 93                                     Brussels	[Belgium]
 94 --- []
 95                                       Aveiro	[Portugal]
 96                                         Beja	[Portugal]
 97                                        Braga	[Portugal]
 98                                     Bragança	[Portugal]
 99                               Castelo Branco	[Portugal]
100                                      Coimbra	[Portugal]
101                                        Évora	[Portugal]
102                                         Faro	[Portugal]
103                                       Guarda	[Portugal]
104                                       Leiria	[Portugal]
105                                       Lisboa	[Portugal]
106                                   Portalegre	[Portugal]
107                                        Porto	[Portugal]
108                                     Santarém	[Portugal]
109                                      Setúbal	[Portugal]
110                             Viana do Castelo	[Portugal]
111                                        Viseu	[Portugal]
112                                    Vila Real	[Portugal]
113                       Arquipélago da Madeira	[Portugal]
114                       Arquipélago dos Açores	[Portugal]
115                              Castilla y León	[Spain]
116                                    Andalucía	[Spain]
117                           Castilla-La Mancha	[Spain]
118 --- []
119                                       Aragón	[Spain]
120                                  Extremadura	[Spain]
121                                     Cataluña	[Spain]
122                                      Galicia	[Spain]
123                         Comunidad Valenciana	[Spain]
124                             Región de Murcia	[Spain]
125                       Principado de Asturias	[Spain]
126                   Comunidad Foral de Navarra	[Spain]
127                          Comunidad de Madrid	[Spain]
128                               Islas Canarias	[Spain]
129                                   País Vasco	[Spain]
130                                    Cantabria	[Spain]
131                                     La Rioja	[Spain]
132                               Islas Baleares	[Spain]
133                                        Ceuta	[Spain]
134                                      Melilla	[Spain]
135                            Baden-Württemberg	[Germany]
136                                       Bayern	[Germany]
137                                       Berlin	[Germany]
138                                  Brandenburg	[Germany]
139                                       Bremen	[Germany]
140                                      Hamburg	[Germany]
141                       Mecklenburg-Vorpommern	[Germany]
142                                Niedersachsen	[Germany]
143                          Nordrhein-Westfalen	[Germany]
144                              Rheinland-Pfalz	[Germany]
145                                     Saarland	[Germany]
146                                      Sachsen	[Germany]
147                               Sachsen-Anhalt	[Germany]
148                           Schleswig-Holstein	[Germany]
149                                    Thüringen	[Germany]
150                                       Hessen	[Germany]
151 --- []
152                                 Western Cape	[South Africa]
153                                 Eastern Cape	[South Africa]
154                                Northern Cape	[South Africa]
155                                   Mpumalanga	[South Africa]
156                                   North West	[South Africa]
157                                Kwazulu Natal	[South Africa]
158                                      Limpopo	[South Africa]
159                                      Gauteng	[South Africa]
160                                   Free State	[South Africa]
161 --- []
162                                         Acre	[Brazil]
163                                      Alagoas	[Brazil]
164                                        Amapá	[Brazil]
165                                     Amazonas	[Brazil]
166                                        Bahia	[Brazil]
167                                        Ceará	[Brazil]
168                             Distrito Federal	[Brazil]
169                               Espírito Santo	[Brazil]
170                                        Goiás	[Brazil]
171                                     Maranhão	[Brazil]
172                                  Mato Grosso	[Brazil]
173                           Mato Grosso do Sul	[Brazil]
174                                 Minas Gerais	[Brazil]
175                                         Pará	[Brazil]
176                                      Paraíba	[Brazil]
177                                       Paraná	[Brazil]
178                                   Pernambuco	[Brazil]
179                                        Piauí	[Brazil]
180                               Rio de Janeiro	[Brazil]
181                          Rio Grande do Norte	[Brazil]
182                            Rio Grande do Sul	[Brazil]
183                                     Rondônia	[Brazil]
184                                      Roraima	[Brazil]
185                               Santa Catarina	[Brazil]
186                                    São Paulo	[Brazil]
187                                      Sergipe	[Brazil]
188                                    Tocantins	[Brazil]
189                                      Abruzzo	[Italy]
190                                   Basilicata	[Italy]
191 --- []
192                                     Calabria	[Italy]
193                                     Campania	[Italy]
194                               Emilia–Romagna	[Italy]
195                        Friuli–Venezia Giulia	[Italy]
196                                        Lazio	[Italy]
197                                      Liguria	[Italy]
198                                    Lombardia	[Italy]
199                                       Marche	[Italy]
200                                       Molise	[Italy]
201                                     Piemonte	[Italy]
202                                       Puglia	[Italy]
203                                     Sardegna	[Italy]
204                                      Sicilia	[Italy]
205                                      Toscana	[Italy]
206                          Trentino–Alto Adige	[Italy]
207                                       Umbria	[Italy]
208                                Valle d'Aosta	[Italy]
209                                       Veneto	[Italy]
210                            Northern Scotland	[United Kingdom]
211                            Southern Scotland	[United Kingdom]
212                           North East England	[United Kingdom]
213                           North West England	[United Kingdom]
214                                    Yorkshire	[United Kingdom]
215                                East Midlands	[United Kingdom]
216                                West Midlands	[United Kingdom]
217                                  North Wales	[United Kingdom]
218                                  South Wales	[United Kingdom]
219                              Eastern England	[United Kingdom]
220                                       London	[United Kingdom]
221                             Southern England	[United Kingdom]
222                           South West England	[United Kingdom]
223                           South East England	[United Kingdom]
224                                       Ulster	[Ireland]
225                                      Munster	[Ireland]
226                                       Dublin	[Ireland]
227                                     Connacht	[Ireland]
228                                     Leinster	[Ireland]
229 ---                          Graubünden (GR)	[Switzerland]
230 ---           Ostschweiz (SG/SH/TG/AI/AR/GL)	[Switzerland]
231 ---                       Region Zürich (ZH)	[Switzerland]
232 ---               Nordwestschweiz (AG/BL/BS)	[Switzerland]
233 ---       Zentralschweiz (ZG/SZ/LU/UR/OW/NW)	[Switzerland]
234 ---                Espace Mittelland (BE/SO)	[Switzerland]
235 ---                Suisse romande (GE/VD/FR)	[Switzerland]
236 ---                             Jura (JU/NE)	[Switzerland]
237 ---                              Wallis (VS)	[Switzerland]
238 ---                              Tessin (TI)	[Switzerland]
239 ---                                  Østfold	[Norway]
240 ---                                 Akershus	[Norway]
241                                         Oslo	[Norway]
242 ---                                  Hedmark	[Norway]
243 ---                                  Oppland	[Norway]
244 ---                                 Buskerud	[Norway]
245 ---                                 Telemark	[Norway]
246 ---                                 Vestfold	[Norway]
247 ---                               Aust-Agder	[Norway]
248 ---                               Vest-Agder	[Norway]
249                                     Rogaland	[Norway]
250 ---                                Hordaland	[Norway]
251 ---                         Sogn og Fjordane	[Norway]
252                              Møre og Romsdal	[Norway]
253 ---                            Sør-Trøndelag	[Norway]
254 ---                           Nord-Trøndelag	[Norway]
255                                     Nordland	[Norway]
256 ---                                    Troms	[Norway]
257 ---                                 Finnmark	[Norway]
258                                   Burgenland	[Austria]
259                                      Kärnten	[Austria]
260                             Niederösterreich	[Austria]
261                               Oberösterreich	[Austria]
262                                     Salzburg	[Austria]
263                                   Steiermark	[Austria]
264                                        Tirol	[Austria]
265                                   Vorarlberg	[Austria]
266 --- []
267 --- []
268 --- []
269 --- []
270 --- []
271 --- []
272 --- []
273                            Jihomoravský kraj	[Czech Republic]
274                               Jihočeský kraj	[Czech Republic]
275                         Královéhradecký kraj	[Czech Republic]
276                             Karlovarský kraj	[Czech Republic]
277                               Liberecký kraj	[Czech Republic]
278                               Olomoucký kraj	[Czech Republic]
279                         Moravskoslezský kraj	[Czech Republic]
280                              Pardubický kraj	[Czech Republic]
281                                Plzeňský kraj	[Czech Republic]
282                             Středočeský kraj	[Czech Republic]
283                                 Ústecký kraj	[Czech Republic]
284                                Kraj Vysočina	[Czech Republic]
285                                 Zlínsky kraj	[Czech Republic]
286                           Hlavni město Praha	[Czech Republic]
287                         Banskobystrický kraj	[Slovakia]
288                            Bratislavský kraj	[Slovakia]
289                                 Košický kraj	[Slovakia]
290                              Nitriansky kraj	[Slovakia]
291                               Prešovský kraj	[Slovakia]
292                             Trenčiansky kraj	[Slovakia]
293                                Trnavský kraj	[Slovakia]
294                                Žilinský kraj	[Slovakia]
295                                         Wien	[Austria]
296                                        Seoul	[South Korea]
297                                        Busan	[South Korea]
298                                        Daegu	[South Korea]
299                                      Incheon	[South Korea]
300                                      Gwangju	[South Korea]
301                                      Daejeon	[South Korea]
302                                        Ulsan	[South Korea]
303                                   Gyeonggido	[South Korea]
304                                    Gangwondo	[South Korea]
305                           Chungcheong buk do	[South Korea]
306                           Chungcheong nam do	[South Korea]
307                                Jeolla buk do	[South Korea]
308                                Jeolla nam do	[South Korea]
309                            Gyeongsang buk do	[South Korea]
310                            Gyeongsang nam do	[South Korea]
311                                       Jejudo	[South Korea]
312                                        Aichi	[Japan]
313                                       Aomori	[Japan]
314                                        Chiba	[Japan]
315                                        Ehime	[Japan]
316                                        Fukui	[Japan]
317                                      Fukuoka	[Japan]
318                                    Fukushima	[Japan]
319                                         Gifu	[Japan]
320                                        Gunma	[Japan]
321                                    Hiroshima	[Japan]
322                                     Hokkaido	[Japan]
323                                        Hyogo	[Japan]
324                                      Ibaraki	[Japan]
325                                     Ishikawa	[Japan]
326                                        Iwate	[Japan]
327                                       Kagawa	[Japan]
328                                    Kagoshima	[Japan]
329                                     Kanagawa	[Japan]
330                                        Kochi	[Japan]
331                                     Kumamoto	[Japan]
332                                        Kyoto	[Japan]
333                                          Mie	[Japan]
334                                       Miyagi	[Japan]
335                                     Miyazaki	[Japan]
336                                       Nagano	[Japan]
337                                     Nagasaki	[Japan]
338                                         Nara	[Japan]
339                                      Niigata	[Japan]
340                                         Oita	[Japan]
341                                      Okayama	[Japan]
342                                      Okinawa	[Japan]
343                                        Osaka	[Japan]
344                                         Saga	[Japan]
345                                      Saitama	[Japan]
346                                        Shiga	[Japan]
347                                      Shimane	[Japan]
348                                     Shizuoka	[Japan]
349                                      Tochigi	[Japan]
350                                    Tokushima	[Japan]
351                                        Tokyo	[Japan]
352                                      Tottori	[Japan]
353                                       Toyama	[Japan]
354                                     Wakayama	[Japan]
355                                     Yamagata	[Japan]
356                                    Yamaguchi	[Japan]
357                                    Yamanashi	[Japan]
358 --- []
359                                     Blekinge	[Sweden]
360                                      Dalarna	[Sweden]
361                                      Gotland	[Sweden]
362                                    Gävleborg	[Sweden]
363                                      Halland	[Sweden]
364                                     Jämtland	[Sweden]
365                                    Jönköping	[Sweden]
366                                       Kalmar	[Sweden]
367                                    Kronoberg	[Sweden]
368                                   Norrbotten	[Sweden]
369                                        Skåne	[Sweden]
370                                    Stockholm	[Sweden]
371                                 Södermanland	[Sweden]
372                                      Uppsala	[Sweden]
373                                     Värmland	[Sweden]
374                                 Västerbotten	[Sweden]
375                               Västernorrland	[Sweden]
376                                  Västmanland	[Sweden]
377                              Västra Götaland	[Sweden]
378                                       Örebro	[Sweden]
379                                 Östergötland	[Sweden]
380 --- []
381 --- []
382 --- []
383                                        Akita	[Japan]
384                                    Groningen	[Netherlands]
385                                      Drenthe	[Netherlands]
386                                   Overijssel	[Netherlands]
387                                   Gelderland	[Netherlands]
388                                      Utrecht	[Netherlands]
389                                Noord-Holland	[Netherlands]
390                                 Zuid-Holland	[Netherlands]
391                                      Zeeland	[Netherlands]
392                                Noord-Brabant	[Netherlands]
393                                      Limburg	[Netherlands]
394                                    Friesland	[Netherlands]
395                                    Flevoland	[Netherlands]
396                                 Dolnośląskie	[Poland]
397                           Kujawsko-Pomorskie	[Poland]
398                                    Lubelskie	[Poland]
399                                     Lubuskie	[Poland]
400                                      Łódzkie	[Poland]
401                                  Małopolskie	[Poland]
402                                  Mazowieckie	[Poland]
403                                     Opolskie	[Poland]
404                                 Podkarpackie	[Poland]
405                                    Podlaskie	[Poland]
406                                    Pomorskie	[Poland]
407                                      Śląskie	[Poland]
408                               Świętokrzyskie	[Poland]
409                          Warmińsko-Mazurskie	[Poland]
410                                Wielkopolskie	[Poland]
411                           Zachodniopomorskie	[Poland]
412 ---                                Aquitaine	[France]
413 ---                                 Auvergne	[France]
414 ---                          Basse-Normandie	[France]
415 ---                                Bourgogne	[France]
416                                     Bretagne	[France]
417                          Centre-Val-de-Loire	[France]
418 ---                        Champagne-Ardenne	[France]
419                                        Corse	[France]
420 ---                            Franche-Comté	[France]
421 ---                          Haute-Normandie	[France]
422                                Île-de-France	[France]
423 ---                     Languedoc-Roussillon	[France]
424 ---                                 Limousin	[France]
425 ---                                 Lorraine	[France]
426 ---                            Midi-Pyrénées	[France]
427 ---                       Nord-Pas-de-Calais	[France]
428                             Pays de la Loire	[France]
429 ---                                 Picardie	[France]
430 ---                         Poitou-Charentes	[France]
431                   Provence-Alpes-Côte d'Azur	[France]
432 ---                              Rhône-Alpes	[France]
433 ---                                   Alsace	[France]
434                                  Bács-Kiskun	[Hungary]
435                                      Baranya	[Hungary]
436                                        Békés	[Hungary]
437                         Borsod-Abaúj-Zemplén	[Hungary]
438                                     Budapest	[Hungary]
439                                     Csongrád	[Hungary]
440                                        Fejér	[Hungary]
441                            Gyor-Moson-Sopron	[Hungary]
442                                  Hajdú-Bihar	[Hungary]
443                                        Heves	[Hungary]
444                         Jász-Nagykun-Szolnok	[Hungary]
445                            Komárom-Esztergom	[Hungary]
446                                       Nógrád	[Hungary]
447                                         Pest	[Hungary]
448                                       Somogy	[Hungary]
449                       Szabolcs-Szatmár-Bereg	[Hungary]
450                                        Tolna	[Hungary]
451                                          Vas	[Hungary]
452                                     Veszprém	[Hungary]
453                                         Zala	[Hungary]
454                               Aguascalientes	[Mexico]
455                              Baja California	[Mexico]
456                          Baja California Sur	[Mexico]
457                                     Campeche	[Mexico]
458                                      Chiapas	[Mexico]
459                                    Chihuahua	[Mexico]
460                                     Coahuila	[Mexico]
461                                       Colima	[Mexico]
462                             Distrito Federal	[Mexico]
463                                      Durango	[Mexico]
464                                   Guanajuato	[Mexico]
465                                     Guerrero	[Mexico]
466                                      Hidalgo	[Mexico]
467                                      Jalisco	[Mexico]
468                                       México	[Mexico]
469                                    Michoacán	[Mexico]
470                                      Morelos	[Mexico]
471                                      Nayarit	[Mexico]
472                                   Nuevo León	[Mexico]
473                                       Oaxaca	[Mexico]
474                                       Puebla	[Mexico]
475                                    Querétaro	[Mexico]
476                                 Quintana Roo	[Mexico]
477                              San Luis Potosí	[Mexico]
478                                      Sinaloa	[Mexico]
479                                       Sonora	[Mexico]
480                                      Tabasco	[Mexico]
481                                   Tamaulipas	[Mexico]
482                                     Tlaxcala	[Mexico]
483                                     Veracruz	[Mexico]
484                                      Yucatán	[Mexico]
485                                    Zacatecas	[Mexico]
486                              Chatham Islands	[New Zealand]
487                                    Normandie	[France]
488                      Bourgogne-Franche-Comté	[France]
489                                    Grand-Est	[France]
490                                    Occitanie	[France]
491                           Nouvelle-Aquitaine	[France]
492                              Hauts-de-France	[France]
493                         Auvergne-Rhône-Alpes	[France]
494                                    Trøndelag	[Norway]
495                                       Sejong	[South Korea]
496 --- []
497                                  Aargau (AG)	[Switzerland]
498                  Appenzell Ausserrhoden (AR)	[Switzerland]
499                   Appenzell Innerrhoden (AI)	[Switzerland]
500                        Basel Landschaft (BL)	[Switzerland]
501                             Basel Stadt (BS)	[Switzerland]
502                                    Bern (BE)	[Switzerland]
503                                Fribourg (FR)	[Switzerland]
504                                  Genève (GE)	[Switzerland]
505                                  Glarus (GL)	[Switzerland]
506                              Graubünden (GR)	[Switzerland]
507                                    Jura (JU)	[Switzerland]
508                                  Luzern (LU)	[Switzerland]
509                               Neuchâtel (NE)	[Switzerland]
510                               Nidwalden (NW)	[Switzerland]
511                                Obwalden (OW)	[Switzerland]
512                            Schaffhausen (SH)	[Switzerland]
513                                  Schwyz (SZ)	[Switzerland]
514                               Solothurn (SO)	[Switzerland]
515                              St. Gallen (SG)	[Switzerland]
516                                 Thurgau (TG)	[Switzerland]
517                                  Ticino (TI)	[Switzerland]
518                                     Uri (UR)	[Switzerland]
519                                  Valais (VS)	[Switzerland]
520                                    Vaud (VD)	[Switzerland]
521                                     Zug (ZG)	[Switzerland]
522                                  Zürich (ZH)	[Switzerland]
523                                      Bonaire	[Bonaire, Sint Eustatius and Saba]
524                               Sint Eustatius	[Bonaire, Sint Eustatius and Saba]
525                                         Saba	[Bonaire, Sint Eustatius and Saba]
526                                     Vestland	[Norway]
527                                        Agder	[Norway]
528                         Vestfold og Telemark	[Norway]
529                                    Innlandet	[Norway]
530                                        Viken	[Norway]
531                            Troms og Finnmark	[Norway]
